  whoami – Return User Name 

 man – command which helps you to understand all the other commands (for example "man whoami") 

 clear – წაშლა ასევე CTRL + L 

 pwd (print working director) - current location directory 

ls – ყველაზე ხშირად გამოყენებადი ბრძანებაა shell-ში და მას ეკრანზე 

გამოაქვს მიმდინარე დირექტორიის2 შიგთავსი, მასში არსებული ფაილებისა და 

დირექტორიების სია 

cd (create directory) - ბრძანებით ერთი დირექტორიიდან მეორეში გადავდივართ ამისთვის უნდა მივუთითთ ის path სადაც გვსურს გადასვლა ფარდობითი გზა მიმდინარე დირექტორიით იწყება. მიმდინარე დირექტორიას 

სპეციალური სიმბოლოს მეშვეობით, ” 

 (წერტილით) აღნიშნავენ. ” .. (ორი წერტილი) მიმდინარე დირექტორიის მამა დირექტორიის აღსანიშნად გამოიყენება. 

mkdir - ახალი ფოლდერის შექმნა rmdir წაშლა 

touch - ფაილის შესაქმნელად  

rm – remove files and directorys 

xdg-open - ავტომატური გახსნა 

mv -  ფაილის  

Სახელის შეცვლა სხვა მისამართზე გადატანაfor example mv journal.txt jurnal.txt and mv jurnal.txt Stuff/        

cp – copy file .  

head & tail – dasawyisi da dasasruli 

sudo super user do -  ადმინისტრატორის უფლებები გვეძლევა ამ ბრძანების ქვეშ 

find / -name "x" - იპოვე ფაილის მდებარეობა მაგალითად sudo find / -type f –name "*.py" შეგვიძლია ვიპოვოთ ყველა ფაილი py გაფართოებით კონკრეტული იუზერის შექმნილი ფაილები sudo find /home/ -type f –user იუზერის სახელი 

locate - სწრაფი ვიდრე find ბრძანება რადგან პირდაპირ ბაზიდან მოაქვს ლოკაცია  locate -I "ფაილის სახელი" მოაქვს ყველა ფაილის მისამართი ამ დასახელებით , ამ ბრძანების მინუსი არის ის რომ find ით მეტი ატრიბუტით ძებნის საშუალება გვაქ . Თუ ეს ბრძანება ვერ პოულობს რაიმე ფაილს მაშინ ჩვენ ხელით უნდა განვაახლოთ ჩვენი უბუნტუს მონაცემთა ბაზა sudo updatedb 

which  - აბრუნებს საძიებო მნიშვნელობას სპეციალური ლოკაციიდან $PATH  გამოაქ მხოლოდ პირველივე ნაპოვნი შედეგი  which –a გამოაქვს ყველა 

echo  - გამომიტანე აქვე 

whereis - გამოაქვს saurce დოკუმენტაცია ფაილის და შეუძლია მრავალი ვერსიის გამოტანა ფაილისთვის 

Თუ გვინდა რომ გამოტანილი შედეგი სტრქიონად ჩავწეროთ ლამაზად  | tr " "  '\n' 

whatis -  რა არის რაღაც? Დოკუმენტაციის მოკლე აღწერა 

type - განსაღზვრება კომანდების 

cat - ახდენს ფაილის შიგთავსის ამოკითხვას  

more - ასევე ახდენს შიგთავსის ამოკითხვას მაგრამ გვიწერს პროცენტებს ანუ უფრო გვეხმარება დიდი ფაილის წაკითხვაში მარა ნაკლებად მოსახერხებელია 

less * -  კითხულობს შიგთავსს და /rasacvedzeb , N შემდეგი ნაპოვნი , shift + N შემდეგი ნაპოვნი  sudo less +F(რომელიც გულისხმობს ახლად განახლებული ფაილის ჩვენებას) /var/log/syslog  

nano - ესეც შექმნა ფაილის როგორც touch მაგრამ ედიტორს ხსნის ეგრევე - nano რედაქტორით მუშაობა: შენახვა (ctrl + o), სტრიქონის ამოჭრა (ctrl + k), ძიება (ctrl + w), ფაილიდან გამოსვლა (ctrl + x);  

sort - სორტირება ხოლო თუ გვინდა ამ შედეგის შენახვა უნდა დავწეროთ > ანუ მაგალითად sort testfile2 > new_file თუ პირიქით სორტირება გვინდა -r(reversed) 

 
diff - ორი ფაილის შედარება + -c გვაძლევს კონტექს რა არის ზუსტად  

  Უფლებები - root , other users, anu User,Group, Others sudo,  chmod 777 ფაილისსახელი - ყველა უფლების მიცემა , read + write + execute 4 + 2 + 1 = 7 , chmod 400 ნიშნავს მხოლოდ წაკითხვის უფლება, chmod u+wx filename tu vaklebt pliusis magivrad minusi 
chmod g+rw,o+r 

Chown root filename 

 